  0:|............................................███..7██...................................██.7F██........................................
  1:|............................................███..███...................................██.████.......................................-
  2:7............................................████.████...............................███████████......................................-
  3:L............................................█████+████..................██.██.......███████████.......................................
  4:............................................██+████████.............██..███.██........███████████.....................................L
  5:L.......................................███.█████+█████.............██████████........████████████....................................-
  6:......................................█████████████████.............████████████████████████████████..██..............................F
  7:J....................................████████+█████████............██████████+████████████████████████████............................L
  8:.....................................██████████████+███............█████████████████+█████████████████████............................7
  9:L...................................██████+████████+██..............██████████████████████████████████████.............................
 10:|.................................████████████████████..............██████████████████████████████████+████...........................F
 11:7................................██████████████████████.............██████████++█████████████████████+█████...........................-
 12:J....................███.........██████+█████████+███████...██.....██+████████████████████████████████████████........................-
 13:L....................█████.██.███+████████████████+██+███...██.██.████████████████+██+██+█████████████████████........................F
 14:-.....................█████████████████████████████████████.██████████████████████████████████████████████████........................-
 15:7......................███████+█████████████████████████+█████████████+███████████████████████████████████████.....██..██.............|
 16:J....................█████+████████████████+████████████████████████████+██████████████████████████████+█████......███████............|
 17:F....................████████████████████████████+█████████████████+████████████████████████████████████████████.█████████............L
 18:L......................████████████████████████████████████████████████████████████████████████████████████████████████████...........F
 19:|......................██████████████████████+█████████████████████████████████████████████████████████████████████████████...........|
 20:7....................███████████████████████████████████+█████████████████████████████████████████+██+████████+██████████+████........L
 21:L.............█████.██████████████████████████████+█████████████████████████████████████████████████████+█████████████████████........L
 22:-.............█████.█████████████████████████████████████████████+██████████████████████████████████████████████████████████████......-
 23:7............███████████+███████████████████████████████████████+█████████████████████████████████████████████████████████████████.....
 24:|............██████████████████████████████████████████+██████████████████████████████████████████████████████████████████████████....7
 25:J............██████+█████████████████████████████████████████████████████+█████████████████████████+███████████+████████████████......L
 26:7............███████████+████████████████+████████+█████████████████████████████████████+███████████████████████████████████++██......F
 27:7.............████████████+█████████████████+█████████████████████████████████████████████+███████████████████████████████+████.......F
 28:|..........██.█████+███████+█████████████████████████████████████████+█████████████████████████████████████████████████████████.......J
 29:-.......█████████████████████████████████████+████████████+██+████████████+██+█████████████████████████████████████████████████.......7
 30:F.......██████████████+███████████████████████████████████████████+█████████████████+███+█████████+██████████████████████████.........L
 31:-........██████+████████████+████████████████████████████████████████+███████████████████████████████████████████████████████..........
 32:F.........████+███████████████████████+██████████████████████+█████████████████+███████+███████+███████████████████████████████.......-
 33:L.........██.████████████+██████+██████████████████████████████████████████████████████████████████████████████████████████████.......-
 34:J............███████████████████████████████████+█████████████████████████████████████████████████████████████████████████+██..........
 35:F.........████████████████████████████████████████████████████████████████████████████████████████████████████████████████+██.........|
 36:J.......████████████████████████████████+██████████████████+███████████████████████████████████████+██+█████████████████++++██........J
 37:-.....████████+████████████████████████████████████+████████████████████████████████████████████████+█████████████+██████+████........J
 38:-...██████████████████████+██████████████████████████████████████████████████████████████+████+███████████████████████████████.██.....-
 39:F...██++████████████████████████████████+███████████+██████+████████████████████████████████████████████████+█████████████████████....-
 40:██..████+██████████████████████████████████████████+██████████████████████+███████████████████████████████████+███████████████████.....
 41:████████████████████████+███████████████████████████████+██████████+██████████████████████████████████████████████+█████████++██......F
 42:█████████████████████████████████████████+██████████████████████████████████████████████████████████+██████████████████████████.......J
 43:L██████████████████████████████████████████████████+███+█████████████████████████+████████████████████+████████████████████████.......F
 44:J███████████████████████████████+████████████████████████████████+██████████████████████████████████████████████████████████████......7
 45:..██+████████+██+██████████████████████████+████████████████████+████+████████████████████████+█████████████████████████████████......L
 46:J..██████████████████████+█████████+████+████████████████████████████████████████+██████████+█████████████████████████████████........J
 47:...█████████████████████████████████████████████████████████████████████████████████████████████████████████████████████████...........
 48:L....███████████████+██████████████████████████████████████+█████████+██████████+███████████████████+██████████████████████...........J
 49:L......█████████████████████████████████████████████████████████████████████████████████████████+██+██████████████████████████........L
 50:F.....████+████+██████████████████████████████████████████+█████████████████████████████████████████████████████████████████████......J
 51:-....███████████+████+█████████████████████████████████████████████+█████+█████████████████+██████████+███████████████████████████....-
 52:.....████████████████████████████████████+█████████████████████+███+███████████████████████████████+███████████████████████████████...7
 53:......████████████████████+██+██+███████████████████████+██████+███+██████████+█████████+█████+████████████████████████████████████...-
 54:-.....████████████████████████████████████████+█████████████+████++███████████++████+███████████+█████████████████████████████++██....J
 55:7.....█████████████████████████████████+█████████████████████████++█████+████████████████████████████████████████████████████+███.....J
 56:L....██████████████████████████████████+████████+██████+██████████+█████+██+██████████████████████████████████████████████+█████████..-
 57:F...███████████████████████████+███████████████████████████████████++███+█████████+██████+██+███████████████████████████████████+███..L
 58:7...█████████████████████████+████+████████████████████████████████++++++████████████████████████████████████+█████████████████++█████J
 59:|....██████████████████████████████████████++█████████████████████+++++++████+███████████████████████████████████+████████████+++█████7
 60:7....██████████████████████████████████+████+██████+██████████████+++++++█████████████████████████████████+████████████████████+█████..
 61:7......███████████████████████████████████████████████████████████+++++++++████████████████████+█████████████████████████████████████.F
 62:L........██████████+██████████████████████████████████████████████++++++++++++██████████████████████████████████████████████████████+██
 63:|.......████+████████████████████████████████████████████+██████++++++++++++++++███████████████████████████████████████████+███████████
 64:F......██████+██████████+███████████████████████████████████+██++++++++++++++++++██+█████████████████████████████████+█████████████████
 65:|......████████████████+██+███████████████████████████████+++++++++++++++++++++++██████████████████████████████████████+███████████████
 66:7.......██+██████+████████████████████+██+██████████████████+++++++++++++++++++++████████████████████████████████████████+█████████████
 67:7...██.████████████████████████████████████+████+███████████++++++++++++++++++++++██████████████████████████+████████████+██████████...
 68:|...██████████+██████████████████████████████████████████++++++++++++++++++++++++█████████████████████████+██+███████████████+███.....L
 69:F...████████████████████████████████████████████████████++++++++++++++++++++++++█████████████████████+█████████████████████+█████......
 70:F..████████████████████████████████████████████████████+███+++++++++++++++++++█████████████+████████████████████████████████████......7
 71:|..████████████████████████████████████████████████+███████+++++++++++++++++++██████████████████+█████████████████████████████........|
 72:-.████████████████████+████████████████████████████+██████++++++++++++++++++++++++███████████████████████████████████████████.........-
 73:J.████████████████████████+██████████████████████████████++++++++++++++++++++++++++██████+██████████████████████+██+███████...........J
 74:-..█████████████████████████████████████████████████+██++++++++++++++++++++++██++++███████████████████+█████████████████████..........F
 75:7...█████████████████████████████████████████████████████++++++++++++++++++████+++████████████████████████████████████████████........J
 76:L....███████████████████████+████████████+███████████████++++++++++++++++++█████+██████+██████████████████████████████████████........|
 77:L....█████████+████+██████████████████████████████+█████++++███++++++++++++++████████████████████████████████████████████████+██......J
 78:J.....███████████████████████████████████████████████████+++███++++++++++++++███████████████████████████████████████████████████......7
 79:-.....██..███████████████████████████████████████████████+█████++++++++++++++█████████████████████+██████████████████████████████████.|
 80:L.........█████+██████████████████████+████████████████████████+++██+++++++++██+███+++████+███████████████+██████████████████+███████.L
 81:7.........████████████████+██████████████+█████████+█████████+++++██+++++++█████████+█████████████████████████+███████████████+████....
 82:F......█████████████████████+█████████████████+███████████████████████+++++███████████████████████████████████████████████████+██.....F
 83:J......███████████████████████████████+███████████████████+███████████+██+++█████████████████████████████████████████████████++██.....-
 84:F......█████████+████+████████████████████████████████+████████████████████+██████+██████████+███████████████+████████████████████....F
 85:L......███████████████████+███████████████+███████████████████████████████████████████████████████████████████████████████████████....7
 86:7.......██████████████+██+███████████████████████████+████████████████████+██++██████████████████+██+███████████████████████████+██...|
 87:-.......███████████+███████████████████████████████████████████████████████████████████████████████████████████████+███████████████...L
 88:7.........█████████████████████████████████████████████████████████████████████████████████████████████████████████████████████████...-
 89:|.........██████████+████████████████████████████████+████████+████████████████+███████████████████+██████████████████████████████+███-
 90:L........███████████+████████████████████████+██████████████████████████████████████████████████████████+█████████████████████████████7
 91:7........██████████████████+███████████████████████████████████████████████████████████████████████████████+████+█████+██████████████..
 92:-......████████████████████████████████████████████████████████+███████████████████████+█████████████████████████+██+█████████████████-
 93:F....█████████████+█████████████████████████████████████████████████████+███████████████████████████+█████████████████████████████████J
 94:7....██████████+████████████████████████████+████████+█████████████████████████████████████████████████████████████████████████████+██.
 95:.....██+█████████████████████████████████████████████████████████████████████████+██████+████████████████████████████████████+███+█████
 96:F...████████████████████████████████████████████████████████████████████████████████████████████████+██████████████████████████████████
 97:L...██████+██+███████████+█████████████████████████████████████████████+█████████████+██████████████████████████████████████████████...
 98:......█████████████████████████+████████████████████+███████████████████+██████████████████████████████████████████████████████████...F
 99:7.....█████████████+██+████████████████████████████+██████████████████████████████████████████████████████+██+████+███████████████....|
100:....████████████████████████████████████████████████████████████████████████████████████████████████████████████████████████████████..7
101:7...██████████████████████+██+████████████████████████████████████████████████████████████████████████+█████████████████████████████..|
102:F..████████████████████████████████████████████████+██+██████████+███████████+██+███████████████████████████████████████████████████..|
103:|..█████+████████████████████████████████████████████████████████████████████████████████████████████████████████████████+████++████..L
104:J..██...████.██+███████████████████████████████████████████████████████████████████+██████████████████+████████████████████████████...-
105:F.......███...███████████████████████████████████████████████████████████████████████████████████████████████████████████████████.....7
106:|...........████████████████████████████████+████+██+████████████████████+██+██████████████████████████████████████+████████████████..-
107:L.........███████+████████████████████████████████████████████████████████████████+███+███████████████████████████+██████████████████.|
108:J.........███████████+█████████████████████████████████████+█████████████████████████████████████████████████████████████████████████.J
109:-.........██████+████████████████████████████████████████████████████████+████+██████████+█████████████████████████████+████████████..7
110:J.............██████████████+█████+███████████████████████████████████████████████+███+█████████████████████████████+████████+███████.J
111:..............████████+██████████████████████████████+██████████████████+███████████+████████████████████████████████████████████████..
112:7................██████████████████████████████████████████████████████████████████████████████+████████+██+████████████████████████..-
113:F................████████████████████████████████████████████████+███████████████████████████████+███████████████████████████+████....7
114:J..................██████████████████████+███+██████████████████████████████████████+██████████████████████████████████████+████......F
115:|...................███████████████████████████+███████████████████████+████████████████████████████████+████+██████████████████......|
116:7...................██████████+███████████+████████████+████████████████████████████████████████████████████████████████████████......F
117:|..................███████████████████████████████+█████████████████████████████████████████+████████████████████████████████████.....|
118:-..................██████████████+███████████████████████████████████████+█████+██████████████████████████████████████████████████....7
119:L...................██.█████████████████████████████████████████████████████████████████████████████+███████████████████████+█████....|
120:.......................██████████████████+███████████+█████████████████████████████████████████████████████+████████████..███.........L
121:F......................███████████+███████████████████████████████████████████████████████████████████████████████████...████.........F
122:L......................███+█████████████████████████+█████.█████████████████████████████████████████+█████+███████████...█████........F
123:-........................████████████████████████████████...██████████+████████+███████████████████████████████████████...████........|
124:J........................██████████████████████████████████.████████████████████████████████++█████████████████████████...............J
125:7.......................███████████+███████████████████████...████++███+████████████████████████+███████████████████..................7
126:|......................██████.█████████████████████████..██...█████████████████████.██+███████████████████████████.....................
127:......................████......████████████████...████.......██████████████████.██.█████████████████+██████+█████....................F
128:7.....................███.........██████████████.................██████+████████.██...█████████████████.██████████....................F
129:-......................██............████████....................███████████████.██.......█████████████.███████.......................-
130:|....................................████......................█████████████.██.............███████████.....███.......................L
131:F.....................................██.......................██████████....................██████████.....███........................
132:7...............................................................█████████....................███.████.................................F
133:L................................................................████████....................███...███................................|
134:F..............................................................██████████....................███...███................................F
135:L..............................................................████.███...............................................................J
136:...............................................................███...██...............................................................7
137:L7JL|L.-.7.L.|7.L..L..7FJL|FLF.|.|-..---7.LJF-F.F.-7-LL.||7F...███--.JLJ-77F|.F77|F7.-||.F..77FL|.J.|-|FL7.J.F7JFJ.|.L...LLJL7-J-LJ|7L7
